08 08 03

XXXXXXXX

X...X..X

X.X.XJGX

X....JGX

X.X.XJGX

X...X..X

XXXXXM.X

XXXXXXXX