09 08 03

XXXXXXXXX

XXX..XXXX

XXX....XX

XXXJGX.XX

X..JGX..X

X.XJG.X.X

XM..X...X

XXXXXXXXX