10 09 04

XXXXXXXXXX

XXX.....XX

XXX.J.M.XX

XXXXX.X.XX

X.J.....XX

X..XJXX.XX

XGGJ..X..X

XGG......X

XXXXXXXXXX