10 07 04

XXXXXXXXXX

XXGGX...XX

X.GGX.J.XX

X.M.J..J.X

XXJXXX...X

XX.....XXX

XXXXXXXXXX