10 08 05

XXXXXXXXXX

XGGGGG..XX

XXX.J.X.XX

XXX.JXX..X

XXXJ.J.J.X

XXX...X..X

XXXX..X.MX

XXXXXXXXXX